# Syntax Coloring Map For JD_ISOBus

# Classes (KEYWORD1)
JD_ISOBus	KEYWORD1
WiFiManager	KEYWORD1

# Methods (KEYWORD2)
begin	KEYWORD2
getMessage	KEYWORD2
parseMessage	KEYWORD2
decodeGrainFlow	KEYWORD2
decodeHeaderInfo	KEYWORD2
isConnected	KEYWORD2
getLocalIP	KEYWORD2
getGateway	KEYWORD2
getSSID	KEYWORD2

# Constants (LITERAL1)
PGN_GRAIN_FLOW	LITERAL1
PGN_HEADER_INFO	LITERAL1
MASK_2_BIT	LITERAL1
MASK_3_BIT	LITERAL1
MASK_8_BIT	LITERAL1 